Team,Season,Games Played,Points For,Goals For,Goals Against,Goal Difference,Goal Ratio,Total Shots For,Total Shots Against,Shot Difference,Total Shot Ratio,Shots on Target For,Shots on Target Against,Shots on Target Difference,Shots on Target Ratio,Shots For Per Game,Shots Against Per Game,Shots on Target For Per Game ,Shots on Target Against Per Game,Goals For Per Game,Goals  Against Per Game
Arsenal,2006/2007,38,68,63,35,28,0.642857143,638,394,244,0.618217054,226,130,96,0.634831461,16.78947368,10.36842105,5.947368421,3.421052632,1.657894737,0.921052632
Aston Villa,2006/2007,38,50,43,41,2,0.511904762,470,512,-42,0.478615071,154,146,8,0.513333333,12.36842105,13.47368421,4.052631579,3.842105263,1.131578947,1.078947368
Blackburn Rovers,2006/2007,38,52,52,54,-2,0.490566038,478,535,-57,0.471865745,155,214,-59,0.420054201,12.57894737,14.07894737,4.078947368,5.631578947,1.368421053,1.421052632
Bolton Wanderers,2006/2007,38,56,47,52,-5,0.474747475,404,500,-96,0.446902655,120,168,-48,0.416666667,10.63157895,13.15789474,3.157894737,4.421052632,1.236842105,1.368421053
Charlton Athletic,2006/2007,38,34,34,60,-26,0.361702128,418,620,-202,0.402697495,133,196,-63,0.404255319,11,16.31578947,3.5,5.157894737,0.894736842,1.578947368
Chelsea,2006/2007,38,83,64,24,40,0.727272727,636,370,266,0.632206759,216,100,116,0.683544304,16.73684211,9.736842105,5.684210526,2.631578947,1.684210526,0.631578947
Everton,2006/2007,38,58,52,36,16,0.590909091,465,580,-115,0.444976077,153,176,-23,0.465045593,12.23684211,15.26315789,4.026315789,4.631578947,1.368421053,0.947368421
Fulham,2006/2007,38,39,38,60,-22,0.387755102,451,543,-92,0.453722334,142,183,-41,0.436923077,11.86842105,14.28947368,3.736842105,4.815789474,1,1.578947368
Liverpool,2006/2007,38,68,57,27,30,0.678571429,668,309,359,0.683725691,214,101,113,0.679365079,17.57894737,8.131578947,5.631578947,2.657894737,1.5,0.710526316
Manchester City,2006/2007,38,42,29,44,-15,0.397260274,454,456,-2,0.498901099,147,123,24,0.544444444,11.94736842,12,3.868421053,3.236842105,0.763157895,1.157894737
Middlesbrough,2006/2007,38,46,44,49,-5,0.47311828,454,537,-83,0.458123108,144,174,-30,0.452830189,11.94736842,14.13157895,3.789473684,4.578947368,1.157894737,1.289473684
Manchester United,2006/2007,38,89,83,27,56,0.754545455,698,411,287,0.629395852,256,120,136,0.680851064,18.36842105,10.81578947,6.736842105,3.157894737,2.184210526,0.710526316
Newcastle United,2006/2007,38,43,38,47,-9,0.447058824,454,567,-113,0.444662096,140,171,-31,0.450160772,11.94736842,14.92105263,3.684210526,4.5,1,1.236842105
Portsmouth,2006/2007,38,54,45,42,3,0.517241379,525,489,36,0.517751479,186,189,-3,0.496,13.81578947,12.86842105,4.894736842,4.973684211,1.184210526,1.105263158
Reading,2006/2007,38,55,52,47,5,0.525252525,419,556,-137,0.42974359,132,213,-81,0.382608696,11.02631579,14.63157895,3.473684211,5.605263158,1.368421053,1.236842105
Sheffield United,2006/2007,38,38,32,55,-23,0.367816092,483,527,-44,0.478217822,147,175,-28,0.456521739,12.71052632,13.86842105,3.868421053,4.605263158,0.842105263,1.447368421
Tottenham Hotspur,2006/2007,38,60,57,54,3,0.513513514,520,494,26,0.512820513,184,144,40,0.56097561,13.68421053,13,4.842105263,3.789473684,1.5,1.421052632
Watford,2006/2007,38,28,29,59,-30,0.329545455,418,576,-158,0.420523139,135,195,-60,0.409090909,11,15.15789474,3.552631579,5.131578947,0.763157895,1.552631579
West Ham United,2006/2007,38,41,35,59,-24,0.372340426,461,576,-115,0.444551591,134,186,-52,0.41875,12.13157895,15.15789474,3.526315789,4.894736842,0.921052632,1.552631579
Wigan Athletic FC,2006/2007,38,38,37,59,-22,0.385416667,474,436,38,0.520879121,147,161,-14,0.477272727,12.47368421,11.47368421,3.868421053,4.236842105,0.973684211,1.552631579
Arsenal,2007/2008,38,83,74,31,43,0.704761905,627,409,218,0.605212355,208,126,82,0.622754491,16.5,10.76315789,5.473684211,3.315789474,1.947368421,0.815789474
Aston Villa,2007/2008,38,60,71,51,20,0.581967213,511,523,-12,0.494197292,182,145,37,0.556574924,13.44736842,13.76315789,4.789473684,3.815789474,1.868421053,1.342105263
Blackburn Rovers,2007/2008,38,58,50,48,2,0.510204082,530,484,46,0.522682446,185,176,9,0.512465374,13.94736842,12.73684211,4.868421053,4.631578947,1.315789474,1.263157895
Birmingham City,2007/2008,38,35,46,62,-16,0.425925926,414,628,-214,0.39731286,143,213,-70,0.401685393,10.89473684,16.52631579,3.763157895,5.605263158,1.210526316,1.631578947
Bolton Wanderers,2007/2008,38,37,36,54,-18,0.4,451,535,-84,0.457403651,149,171,-22,0.465625,11.86842105,14.07894737,3.921052632,4.5,0.947368421,1.421052632
Chelsea,2007/2008,38,85,65,26,39,0.714285714,605,436,169,0.58117195,199,121,78,0.621875,15.92105263,11.47368421,5.236842105,3.184210526,1.710526316,0.684210526
Derby County,2007/2008,38,11,20,89,-69,0.183486239,376,629,-253,0.374129353,116,234,-118,0.331428571,9.894736842,16.55263158,3.052631579,6.157894737,0.526315789,2.342105263
Everton,2007/2008,38,65,55,33,22,0.625,474,489,-15,0.492211838,169,131,38,0.563333333,12.47368421,12.86842105,4.447368421,3.447368421,1.447368421,0.868421053
Fulham,2007/2008,38,36,38,60,-22,0.387755102,469,560,-91,0.455782313,154,200,-46,0.435028249,12.34210526,14.73684211,4.052631579,5.263157895,1,1.578947368
Liverpool,2007/2008,38,76,67,28,39,0.705263158,686,339,347,0.669268293,214,87,127,0.710963455,18.05263158,8.921052632,5.631578947,2.289473684,1.763157895,0.736842105
Manchester City,2007/2008,38,55,45,53,-8,0.459183673,423,577,-154,0.423,143,199,-56,0.418128655,11.13157895,15.18421053,3.763157895,5.236842105,1.184210526,1.394736842
Manchester United,2007/2008,38,87,80,22,58,0.784313725,696,430,266,0.618117229,260,130,130,0.666666667,18.31578947,11.31578947,6.842105263,3.421052632,2.105263158,0.578947368
Middlesbrough,2007/2008,38,42,43,53,-10,0.447916667,499,512,-13,0.493570722,152,152,0,0.5,13.13157895,13.47368421,4,4,1.131578947,1.394736842
Newcastle United,2007/2008,38,43,45,65,-20,0.409090909,481,556,-75,0.463837994,153,191,-38,0.444767442,12.65789474,14.63157895,4.026315789,5.026315789,1.184210526,1.710526316
Portsmouth,2007/2008,38,57,48,40,8,0.545454545,559,527,32,0.514732965,160,188,-28,0.459770115,14.71052632,13.86842105,4.210526316,4.947368421,1.263157895,1.052631579
Reading,2007/2008,38,36,41,66,-25,0.38317757,441,613,-172,0.418406072,132,221,-89,0.373937677,11.60526316,16.13157895,3.473684211,5.815789474,1.078947368,1.736842105
Sunderland,2007/2008,38,39,36,59,-23,0.378947368,483,495,-12,0.493865031,137,156,-19,0.467576792,12.71052632,13.02631579,3.605263158,4.105263158,0.947368421,1.552631579
Tottenham Hotspur,2007/2008,38,46,66,61,5,0.519685039,555,488,67,0.532118888,195,171,24,0.532786885,14.60526316,12.84210526,5.131578947,4.5,1.736842105,1.605263158
West Ham United,2007/2008,38,49,42,50,-8,0.456521739,500,541,-41,0.480307397,154,174,-20,0.469512195,13.15789474,14.23684211,4.052631579,4.578947368,1.105263158,1.315789474
Wigan Athletic FC,2007/2008,38,40,34,51,-17,0.4,489,498,-9,0.495440729,141,160,-19,0.468438538,12.86842105,13.10526316,3.710526316,4.210526316,0.894736842,1.342105263
Arsenal,2008/2009,38,72,68,37,31,0.647619048,662,401,261,0.622765757,220,143,77,0.606060606,17.42105263,10.55263158,5.789473684,3.763157895,1.789473684,0.973684211
Aston Villa,2008/2009,38,62,54,48,6,0.529411765,472,551,-79,0.461388074,159,176,-17,0.474626866,12.42105263,14.5,4.184210526,4.631578947,1.421052632,1.263157895
Blackburn Rovers,2008/2009,38,41,40,60,-20,0.4,473,505,-32,0.483640082,148,159,-11,0.482084691,12.44736842,13.28947368,3.894736842,4.184210526,1.052631579,1.578947368
Bolton Wanderers,2008/2009,38,41,41,53,-12,0.436170213,488,691,-203,0.413910093,154,204,-50,0.430167598,12.84210526,18.18421053,4.052631579,5.368421053,1.078947368,1.394736842
Chelsea,2008/2009,38,83,68,24,44,0.739130435,797,438,359,0.64534413,248,118,130,0.677595628,20.97368421,11.52631579,6.526315789,3.105263158,1.789473684,0.631578947
Everton,2008/2009,38,63,55,37,18,0.597826087,496,514,-18,0.491089109,169,152,17,0.526479751,13.05263158,13.52631579,4.447368421,4,1.447368421,0.973684211
Fulham,2008/2009,38,53,39,34,5,0.534246575,511,599,-88,0.46036036,149,177,-28,0.457055215,13.44736842,15.76315789,3.921052632,4.657894737,1.026315789,0.894736842
Hull City,2008/2009,38,35,39,64,-25,0.378640777,476,619,-143,0.434703196,149,175,-26,0.459876543,12.52631579,16.28947368,3.921052632,4.605263158,1.026315789,1.684210526
Liverpool,2008/2009,38,86,77,27,50,0.740384615,736,311,425,0.70296084,224,107,117,0.67673716,19.36842105,8.184210526,5.894736842,2.815789474,2.026315789,0.710526316
Manchester City,2008/2009,38,50,58,50,8,0.537037037,572,546,26,0.511627907,201,176,25,0.533156499,15.05263158,14.36842105,5.289473684,4.631578947,1.526315789,1.315789474
Manchester United,2008/2009,38,90,68,24,44,0.739130435,715,438,277,0.620121422,230,119,111,0.659025788,18.81578947,11.52631579,6.052631579,3.131578947,1.789473684,0.631578947
Middlesbrough,2008/2009,38,32,28,57,-29,0.329411765,498,637,-139,0.43876652,140,203,-63,0.408163265,13.10526316,16.76315789,3.684210526,5.342105263,0.736842105,1.5
Newcastle United,2008/2009,38,34,40,59,-19,0.404040404,444,620,-176,0.417293233,125,197,-72,0.388198758,11.68421053,16.31578947,3.289473684,5.184210526,1.052631579,1.552631579
Portsmouth,2008/2009,38,41,38,57,-19,0.4,500,562,-62,0.470809793,152,196,-44,0.436781609,13.15789474,14.78947368,4,5.157894737,1,1.5
Stoke City,2008/2009,38,45,38,55,-17,0.408602151,364,604,-240,0.376033058,100,183,-83,0.35335689,9.578947368,15.89473684,2.631578947,4.815789474,1,1.447368421
Sunderland,2008/2009,38,36,34,54,-20,0.386363636,473,587,-114,0.446226415,144,172,-28,0.455696203,12.44736842,15.44736842,3.789473684,4.526315789,0.894736842,1.421052632
Tottenham Hotspur,2008/2009,38,51,45,45,0,0.5,544,516,28,0.513207547,177,171,6,0.50862069,14.31578947,13.57894737,4.657894737,4.5,1.184210526,1.184210526
West Bromwich Albion,2008/2009,38,32,36,67,-31,0.349514563,559,602,-43,0.481481481,165,225,-60,0.423076923,14.71052632,15.84210526,4.342105263,5.921052632,0.947368421,1.763157895
West Ham United,2008/2009,38,51,42,45,-3,0.482758621,515,669,-154,0.434966216,167,182,-15,0.478510029,13.55263158,17.60526316,4.394736842,4.789473684,1.105263158,1.184210526
Wigan Athletic FC,2008/2009,38,45,34,45,-11,0.430379747,590,475,115,0.55399061,163,149,14,0.522435897,15.52631579,12.5,4.289473684,3.921052632,0.894736842,1.184210526
Arsenal,2009/2010,38,75,83,41,42,0.669354839,660,384,276,0.632183908,233,133,100,0.636612022,17.36842105,10.10526316,6.131578947,3.5,2.184210526,1.078947368
Aston Villa,2009/2010,38,64,52,39,13,0.571428571,497,609,-112,0.449367089,158,165,-7,0.489164087,13.07894737,16.02631579,4.157894737,4.342105263,1.368421053,1.026315789
Birmingham City,2009/2010,38,50,38,47,-9,0.447058824,452,656,-204,0.407942238,155,182,-27,0.459940653,11.89473684,17.26315789,4.078947368,4.789473684,1,1.236842105
Blackburn Rovers,2009/2010,38,50,41,55,-14,0.427083333,489,509,-20,0.48997996,161,170,-9,0.486404834,12.86842105,13.39473684,4.236842105,4.473684211,1.078947368,1.447368421
Bolton Wanderers,2009/2010,38,39,42,67,-25,0.385321101,558,614,-56,0.476109215,163,211,-48,0.435828877,14.68421053,16.15789474,4.289473684,5.552631579,1.105263158,1.763157895
Burnley,2009/2010,38,30,42,82,-40,0.338709677,459,636,-177,0.419178082,153,236,-83,0.393316195,12.07894737,16.73684211,4.026315789,6.210526316,1.105263158,2.157894737
Chelsea,2009/2010,38,86,103,32,71,0.762962963,834,373,461,0.690969345,288,105,183,0.732824427,21.94736842,9.815789474,7.578947368,2.763157895,2.710526316,0.842105263
Everton,2009/2010,38,61,60,49,11,0.550458716,589,506,83,0.537899543,194,161,33,0.546478873,15.5,13.31578947,5.105263158,4.236842105,1.578947368,1.289473684
Fulham,2009/2010,38,46,39,46,-7,0.458823529,463,553,-90,0.455708661,144,173,-29,0.454258675,12.18421053,14.55263158,3.789473684,4.552631579,1.026315789,1.210526316
Hull City,2009/2010,38,30,34,75,-41,0.311926606,388,658,-270,0.370936902,120,210,-90,0.363636364,10.21052632,17.31578947,3.157894737,5.526315789,0.894736842,1.973684211
Liverpool,2009/2010,38,63,61,35,26,0.635416667,642,387,255,0.623906706,189,134,55,0.585139319,16.89473684,10.18421053,4.973684211,3.526315789,1.605263158,0.921052632
Manchester City,2009/2010,38,67,73,45,28,0.618644068,526,514,12,0.505769231,195,153,42,0.560344828,13.84210526,13.52631579,5.131578947,4.026315789,1.921052632,1.184210526
Manchester United,2009/2010,38,85,86,28,58,0.754385965,695,415,280,0.626126126,221,134,87,0.622535211,18.28947368,10.92105263,5.815789474,3.526315789,2.263157895,0.736842105
Portsmouth,2009/2010,38,28,34,66,-32,0.34,533,585,-52,0.476744186,151,199,-48,0.431428571,14.02631579,15.39473684,3.973684211,5.236842105,0.894736842,1.736842105
Stoke City,2009/2010,38,47,34,48,-14,0.414634146,402,580,-178,0.409368635,113,176,-63,0.39100346,10.57894737,15.26315789,2.973684211,4.631578947,0.894736842,1.263157895
Sunderland,2009/2010,38,44,48,56,-8,0.461538462,444,618,-174,0.418079096,159,184,-25,0.463556851,11.68421053,16.26315789,4.184210526,4.842105263,1.263157895,1.473684211
Tottenham Hotspur,2009/2010,38,70,67,41,26,0.62037037,681,520,161,0.567027477,226,176,50,0.562189055,17.92105263,13.68421053,5.947368421,4.631578947,1.763157895,1.078947368
West Ham United,2009/2010,38,35,47,66,-19,0.415929204,549,603,-54,0.4765625,191,191,0,0.5,14.44736842,15.86842105,5.026315789,5.026315789,1.236842105,1.736842105
Wigan Athletic FC,2009/2010,38,36,37,79,-42,0.318965517,555,543,12,0.505464481,173,200,-27,0.463806971,14.60526316,14.28947368,4.552631579,5.263157895,0.973684211,2.078947368
Wolves,2009/2010,38,38,32,56,-24,0.363636364,436,589,-153,0.425365854,119,213,-94,0.358433735,11.47368421,15.5,3.131578947,5.605263158,0.842105263,1.473684211
Arsenal,2010/2011,38,68,72,43,29,0.626086957,654,403,251,0.618732261,238,139,99,0.631299735,17.21052632,10.60526316,6.263157895,3.657894737,1.894736842,1.131578947
Aston Villa,2010/2011,38,48,48,59,-11,0.448598131,506,600,-94,0.457504521,165,171,-6,0.491071429,13.31578947,15.78947368,4.342105263,4.5,1.263157895,1.552631579
Birmingham City,2010/2011,38,39,37,58,-21,0.389473684,401,687,-286,0.368566176,121,232,-111,0.342776204,10.55263158,18.07894737,3.184210526,6.105263158,0.973684211,1.526315789
Blackburn Rovers,2010/2011,38,43,46,59,-13,0.438095238,453,615,-162,0.424157303,135,184,-49,0.423197492,11.92105263,16.18421053,3.552631579,4.842105263,1.210526316,1.552631579
Blackpool,2010/2011,38,39,55,78,-23,0.413533835,531,737,-206,0.418769716,161,234,-73,0.407594937,13.97368421,19.39473684,4.236842105,6.157894737,1.447368421,2.052631579
Bolton Wanderers,2010/2011,38,46,52,56,-4,0.481481481,570,600,-30,0.487179487,173,199,-26,0.465053763,15,15.78947368,4.552631579,5.236842105,1.368421053,1.473684211
Chelsea,2010/2011,38,71,69,33,36,0.676470588,745,441,304,0.628161889,244,136,108,0.642105263,19.60526316,11.60526316,6.421052632,3.578947368,1.815789474,0.868421053
Everton,2010/2011,38,54,51,45,6,0.53125,580,505,75,0.534562212,181,141,40,0.562111801,15.26315789,13.28947368,4.763157895,3.710526316,1.342105263,1.184210526
Fulham,2010/2011,38,49,49,43,6,0.532608696,547,532,15,0.50695088,172,166,6,0.50887574,14.39473684,14,4.526315789,4.368421053,1.289473684,1.131578947
Liverpool,2010/2011,38,58,59,44,15,0.572815534,582,490,92,0.542910448,205,142,63,0.590778098,15.31578947,12.89473684,5.394736842,3.736842105,1.552631579,1.157894737
Manchester City,2010/2011,38,71,60,33,27,0.64516129,546,512,34,0.516068053,177,141,36,0.556603774,14.36842105,13.47368421,4.657894737,3.710526316,1.578947368,0.868421053
Manchester United,2010/2011,38,80,78,37,41,0.67826087,618,459,159,0.573816156,212,124,88,0.630952381,16.26315789,12.07894737,5.578947368,3.263157895,2.052631579,0.973684211
Newcastle United,2010/2011,38,46,56,57,-1,0.495575221,507,505,2,0.500988142,168,153,15,0.523364486,13.34210526,13.28947368,4.421052632,4.026315789,1.473684211,1.5
Stoke City,2010/2011,38,46,46,48,-2,0.489361702,482,547,-65,0.468415938,143,172,-29,0.453968254,12.68421053,14.39473684,3.763157895,4.526315789,1.210526316,1.263157895
Sunderland,2010/2011,38,47,45,56,-11,0.445544554,532,549,-17,0.49213691,154,189,-35,0.448979592,14,14.44736842,4.052631579,4.973684211,1.184210526,1.473684211
Tottenham Hotspur,2010/2011,38,62,55,46,9,0.544554455,657,565,92,0.537643208,191,186,5,0.5066313,17.28947368,14.86842105,5.026315789,4.894736842,1.447368421,1.210526316
West Bromwich Albion,2010/2011,38,47,56,71,-15,0.440944882,597,531,66,0.529255319,184,179,5,0.506887052,15.71052632,13.97368421,4.842105263,4.710526316,1.473684211,1.868421053
West Ham United,2010/2011,38,33,43,70,-27,0.380530973,572,694,-122,0.451816746,174,237,-63,0.423357664,15.05263158,18.26315789,4.578947368,6.236842105,1.131578947,1.842105263
Wigan Athletic FC,2010/2011,38,42,40,61,-21,0.396039604,511,507,4,0.501964637,170,188,-18,0.474860335,13.44736842,13.34210526,4.473684211,4.947368421,1.052631579,1.605263158
Wolves,2010/2011,38,40,46,66,-20,0.410714286,459,571,-112,0.445631068,139,194,-55,0.417417417,12.07894737,15.02631579,3.657894737,5.105263158,1.210526316,1.736842105
Arsenal,2011/2012,38,70,74,49,25,0.601626016,637,393,244,0.618446602,237,131,106,0.644021739,16.76315789,10.34210526,6.236842105,3.447368421,1.947368421,1.289473684
Aston Villa,2011/2012,38,38,37,53,-16,0.411111111,438,578,-140,0.431102362,138,176,-38,0.439490446,11.52631579,15.21052632,3.631578947,4.631578947,0.973684211,1.394736842
Blackburn Rovers,2011/2012,38,31,48,78,-30,0.380952381,453,617,-164,0.423364486,143,186,-43,0.434650456,11.92105263,16.23684211,3.763157895,4.894736842,1.263157895,2.052631579
Bolton Wanderers,2011/2012,38,36,46,77,-31,0.37398374,495,656,-161,0.430060817,162,222,-60,0.421875,13.02631579,17.26315789,4.263157895,5.842105263,1.210526316,2.026315789
Chelsea,2011/2012,38,64,65,46,19,0.585585586,671,449,222,0.599107143,224,153,71,0.594164456,17.65789474,11.81578947,5.894736842,4.026315789,1.710526316,1.210526316
Everton,2011/2012,38,56,50,40,10,0.555555556,520,473,47,0.52366566,164,133,31,0.552188552,13.68421053,12.44736842,4.315789474,3.5,1.315789474,1.052631579
Fulham,2011/2012,38,52,48,51,-3,0.484848485,541,587,-46,0.479609929,195,198,-3,0.496183206,14.23684211,15.44736842,5.131578947,5.210526316,1.263157895,1.342105263
Liverpool,2011/2012,38,52,47,40,7,0.540229885,667,421,246,0.613051471,207,129,78,0.616071429,17.55263158,11.07894737,5.447368421,3.394736842,1.236842105,1.052631579
Manchester City,2011/2012,38,89,93,29,64,0.762295082,738,397,341,0.650220264,250,131,119,0.656167979,19.42105263,10.44736842,6.578947368,3.447368421,2.447368421,0.763157895
Manchester United,2011/2012,38,89,89,33,56,0.729508197,646,506,140,0.560763889,243,156,87,0.609022556,17,13.31578947,6.394736842,4.105263158,2.342105263,0.868421053
Newcastle United,2011/2012,38,65,56,51,5,0.523364486,489,543,-54,0.473837209,154,175,-21,0.468085106,12.86842105,14.28947368,4.052631579,4.605263158,1.473684211,1.342105263
Norwich City,2011/2012,38,47,52,66,-14,0.440677966,514,614,-100,0.455673759,164,216,-52,0.431578947,13.52631579,16.15789474,4.315789474,5.684210526,1.368421053,1.736842105
Queens Park Rangers F.C.,2011/2012,38,37,43,66,-23,0.394495413,539,628,-89,0.461868038,150,198,-48,0.431034483,14.18421053,16.52631579,3.947368421,5.210526316,1.131578947,1.736842105
Stoke City,2011/2012,38,45,36,53,-17,0.404494382,376,538,-162,0.411378556,94,178,-84,0.345588235,9.894736842,14.15789474,2.473684211,4.684210526,0.947368421,1.394736842
Sunderland,2011/2012,38,45,45,46,-1,0.494505495,458,617,-159,0.426046512,141,172,-31,0.450479233,12.05263158,16.23684211,3.710526316,4.526315789,1.184210526,1.210526316
Swansea City,2011/2012,38,47,44,51,-7,0.463157895,472,596,-124,0.441947566,145,188,-43,0.435435435,12.42105263,15.68421053,3.815789474,4.947368421,1.157894737,1.342105263
Tottenham Hotspur,2011/2012,38,69,66,41,25,0.61682243,701,464,237,0.601716738,230,160,70,0.58974359,18.44736842,12.21052632,6.052631579,4.210526316,1.736842105,1.078947368
West Bromwich Albion,2011/2012,38,47,45,52,-7,0.463917526,544,589,-45,0.480141218,167,172,-5,0.492625369,14.31578947,15.5,4.394736842,4.526315789,1.184210526,1.368421053
Wigan Athletic FC,2011/2012,38,43,42,62,-20,0.403846154,519,557,-38,0.482342007,162,184,-22,0.468208092,13.65789474,14.65789474,4.263157895,4.842105263,1.105263158,1.631578947
Wolves,2011/2012,38,25,40,82,-42,0.327868852,473,668,-195,0.414548642,152,264,-112,0.365384615,12.44736842,17.57894737,4,6.947368421,1.052631579,2.157894737
Arsenal,2012/2013,38,73,72,37,35,0.660550459,598,401,197,0.598598599,205,143,62,0.58908046,15.73684211,10.55263158,5.394736842,3.763157895,1.894736842,0.921052632
Aston Villa,2012/2013,38,41,47,69,-22,0.405172414,438,633,-195,0.408963585,141,188,-47,0.428571429,11.52631579,16.65789474,3.710526316,4.947368421,1.236842105,1.815789474
Chelsea,2012/2013,38,75,75,39,36,0.657894737,627,464,163,0.574702108,212,161,51,0.568364611,16.5,12.21052632,5.578947368,4.236842105,1.973684211,1.026315789
Everton,2012/2013,38,63,55,40,15,0.578947368,633,452,181,0.583410138,207,148,59,0.583098592,16.65789474,11.89473684,5.447368421,3.894736842,1.447368421,1.052631579
Fulham,2012/2013,38,43,50,60,-10,0.454545455,460,638,-178,0.418943534,160,211,-51,0.431266846,12.10526316,16.78947368,4.210526316,5.552631579,1.315789474,1.578947368
Liverpool,2012/2013,38,61,71,43,28,0.622807018,739,433,306,0.630546075,232,141,91,0.621983914,19.44736842,11.39473684,6.105263158,3.710526316,1.868421053,1.131578947
Manchester City,2012/2013,38,78,66,34,32,0.66,659,395,264,0.625237192,230,116,114,0.664739884,17.34210526,10.39473684,6.052631579,3.052631579,1.736842105,0.894736842
Manchester United,2012/2013,38,89,86,43,43,0.666666667,560,485,75,0.535885167,213,149,64,0.58839779,14.73684211,12.76315789,5.605263158,3.921052632,2.263157895,1.131578947
Newcastle United,2012/2013,38,41,45,68,-23,0.398230088,532,509,23,0.51104707,174,186,-12,0.483333333,14,13.39473684,4.578947368,4.894736842,1.184210526,1.789473684
Norwich City,2012/2013,38,44,41,58,-17,0.414141414,413,534,-121,0.436114044,134,180,-46,0.426751592,10.86842105,14.05263158,3.526315789,4.736842105,1.078947368,1.526315789
Queens Park Rangers F.C.,2012/2013,38,25,30,60,-30,0.333333333,500,599,-99,0.454959054,147,204,-57,0.418803419,13.15789474,15.76315789,3.868421053,5.368421053,0.789473684,1.578947368
Reading,2012/2013,38,28,43,73,-30,0.370689655,393,706,-313,0.357597816,129,240,-111,0.349593496,10.34210526,18.57894737,3.394736842,6.315789474,1.131578947,1.921052632
Southampton,2012/2013,38,41,49,60,-11,0.449541284,516,447,69,0.535825545,166,155,11,0.517133956,13.57894737,11.76315789,4.368421053,4.078947368,1.289473684,1.578947368
Stoke City,2012/2013,38,42,34,45,-11,0.430379747,390,545,-155,0.417112299,114,154,-40,0.425373134,10.26315789,14.34210526,3,4.052631579,0.894736842,1.184210526
Sunderland,2012/2013,38,39,41,54,-13,0.431578947,417,633,-216,0.397142857,139,207,-68,0.401734104,10.97368421,16.65789474,3.657894737,5.447368421,1.078947368,1.421052632
Swansea City,2012/2013,38,46,47,51,-4,0.479591837,505,567,-62,0.47108209,167,206,-39,0.44772118,13.28947368,14.92105263,4.394736842,5.421052632,1.236842105,1.342105263
Tottenham Hotspur,2012/2013,38,72,66,46,20,0.589285714,681,369,312,0.648571429,241,128,113,0.653116531,17.92105263,9.710526316,6.342105263,3.368421053,1.736842105,1.210526316
West Bromwich Albion,2012/2013,38,49,53,57,-4,0.481818182,506,592,-86,0.460837887,170,189,-19,0.473537604,13.31578947,15.57894737,4.473684211,4.973684211,1.394736842,1.5
West Ham United,2012/2013,38,46,45,53,-8,0.459183673,493,625,-132,0.440966011,158,220,-62,0.417989418,12.97368421,16.44736842,4.157894737,5.789473684,1.184210526,1.394736842
Wigan Athletic FC,2012/2013,38,36,47,73,-26,0.391666667,500,533,-33,0.484027106,170,183,-13,0.481586402,13.15789474,14.02631579,4.473684211,4.815789474,1.236842105,1.921052632
Arsenal ,2013/2014,38,79,68,41,27,0.623853211,523,452,71,0.536410256,209,157,52,0.571038251,13.76315789,11.89473684,5.5,4.131578947,1.789473684,1.078947368
Aston Villa,2013/2014,38,38,39,61,-22,0.39,431,493,-62,0.466450216,135,170,-35,0.442622951,11.34210526,12.97368421,3.552631579,4.473684211,1.026315789,1.605263158
Cardiff City,2013/2014,38,30,32,74,-42,0.301886792,418,692,-274,0.376576577,124,232,-108,0.348314607,11,18.21052632,3.263157895,6.105263158,0.842105263,1.947368421
Chelsea,2013/2014,38,82,71,27,44,0.724489796,692,393,299,0.637788018,229,122,107,0.652421652,18.21052632,10.34210526,6.026315789,3.210526316,1.868421053,0.710526316
Crystal Palace,2013/2014,38,45,33,48,-15,0.407407407,414,529,-115,0.43902439,143,169,-26,0.458333333,10.89473684,13.92105263,3.763157895,4.447368421,0.868421053,1.263157895
Everton,2013/2014,38,72,61,39,22,0.61,561,493,68,0.532258065,196,153,43,0.561604585,14.76315789,12.97368421,5.157894737,4.026315789,1.605263158,1.026315789
Fulham,2013/2014,38,32,40,85,-45,0.32,431,671,-240,0.391107078,149,246,-97,0.37721519,11.34210526,17.65789474,3.921052632,6.473684211,1.052631579,2.236842105
Hull City,2013/2014,38,37,38,53,-15,0.417582418,429,531,-102,0.446875,132,163,-31,0.447457627,11.28947368,13.97368421,3.473684211,4.289473684,1,1.394736842
Liverpool,2013/2014,38,84,101,50,51,0.668874172,651,479,172,0.576106195,258,152,106,0.629268293,17.13157895,12.60526316,6.789473684,4,2.657894737,1.315789474
Manchester City,2013/2014,38,86,102,37,65,0.73381295,673,358,315,0.652764306,238,115,123,0.674220963,17.71052632,9.421052632,6.263157895,3.026315789,2.684210526,0.973684211
Manchester United,2013/2014,38,64,64,43,21,0.598130841,526,453,73,0.537282942,183,144,39,0.559633028,13.84210526,11.92105263,4.815789474,3.789473684,1.684210526,1.131578947
Newcastle United,2013/2014,38,49,43,59,-16,0.421568627,579,485,94,0.544172932,182,170,12,0.517045455,15.23684211,12.76315789,4.789473684,4.473684211,1.131578947,1.552631579
Norwich City,2013/2014,38,33,28,62,-34,0.311111111,467,582,-115,0.445185891,148,193,-45,0.434017595,12.28947368,15.31578947,3.894736842,5.078947368,0.736842105,1.631578947
Southampton,2013/2014,38,56,54,46,8,0.54,534,365,169,0.593993326,179,130,49,0.579288026,14.05263158,9.605263158,4.710526316,3.421052632,1.421052632,1.210526316
Stoke City,2013/2014,38,50,45,52,-7,0.463917526,428,548,-120,0.447698745,137,180,-43,0.432176656,11.26315789,14.42105263,3.605263158,4.736842105,1.184210526,1.368421053
Sunderland,2013/2014,38,38,41,60,-19,0.405940594,491,636,-145,0.43566992,138,214,-76,0.392045455,12.92105263,16.73684211,3.631578947,5.631578947,1.078947368,1.578947368
Swansea City,2013/2014,38,42,54,54,0,0.5,495,481,14,0.507172131,162,155,7,0.511041009,13.02631579,12.65789474,4.263157895,4.078947368,1.421052632,1.421052632
Tottenham Hotspur,2013/2014,38,69,55,51,4,0.518867925,587,424,163,0.580613254,192,157,35,0.550143266,15.44736842,11.15789474,5.052631579,4.131578947,1.447368421,1.342105263
West Bromwich Albion,2013/2014,38,36,43,59,-16,0.421568627,486,494,-8,0.495918367,147,171,-24,0.462264151,12.78947368,13,3.868421053,4.5,1.131578947,1.552631579
West Ham United,2013/2014,38,40,40,51,-11,0.43956044,422,679,-257,0.38328792,122,207,-85,0.370820669,11.10526316,17.86842105,3.210526316,5.447368421,1.052631579,1.342105263
Arsenal,2014/2015,38,75,71,36,35,0.663551402,612,407,205,0.600588813,228,130,98,0.636871508,16.10526316,10.71052632,6,3.421052632,1.868421053,0.947368421
Aston Villa,2014/2015,38,38,31,57,-26,0.352272727,414,478,-64,0.464125561,127,170,-43,0.427609428,10.89473684,12.57894737,3.342105263,4.473684211,0.815789474,1.5
Burnley,2014/2015,38,33,28,53,-25,0.345679012,429,589,-160,0.421414538,125,187,-62,0.400641026,11.28947368,15.5,3.289473684,4.921052632,0.736842105,1.394736842
Chelsea,2014/2015,38,87,73,32,41,0.695238095,563,416,147,0.575076609,210,124,86,0.628742515,14.81578947,10.94736842,5.526315789,3.263157895,1.921052632,0.842105263
Crystal Palace,2014/2015,38,48,47,51,-4,0.479591837,438,525,-87,0.45482866,139,151,-12,0.479310345,11.52631579,13.81578947,3.657894737,3.973684211,1.236842105,1.342105263
Everton,2014/2015,38,47,48,50,-2,0.489795918,484,501,-17,0.491370558,166,128,38,0.56462585,12.73684211,13.18421053,4.368421053,3.368421053,1.263157895,1.315789474
Hull City,2014/2015,38,35,33,51,-18,0.392857143,429,499,-70,0.462284483,131,157,-26,0.454861111,11.28947368,13.13157895,3.447368421,4.131578947,0.868421053,1.342105263
Leicester City,2014/2015,38,41,46,55,-9,0.455445545,457,552,-95,0.452923687,137,173,-36,0.441935484,12.02631579,14.52631579,3.605263158,4.552631579,1.210526316,1.447368421
Liverpool,2014/2015,38,62,52,48,4,0.52,590,415,175,0.587064677,194,143,51,0.575667656,15.52631579,10.92105263,5.105263158,3.763157895,1.368421053,1.263157895
Manchester City,2014/2015,38,79,83,38,45,0.685950413,668,388,280,0.632575758,228,129,99,0.638655462,17.57894737,10.21052632,6,3.394736842,2.184210526,1
Manchester United,2014/2015,38,70,62,37,25,0.626262626,509,379,130,0.573198198,179,140,39,0.561128527,13.39473684,9.973684211,4.710526316,3.684210526,1.631578947,0.973684211
Newcastle United,2014/2015,38,39,40,63,-23,0.388349515,467,443,24,0.513186813,143,163,-20,0.467320261,12.28947368,11.65789474,3.763157895,4.289473684,1.052631579,1.657894737
Queens Park Rangers F.C.,2014/2015,38,30,42,73,-31,0.365217391,533,618,-85,0.463075586,151,216,-65,0.411444142,14.02631579,16.26315789,3.973684211,5.684210526,1.105263158,1.921052632
Southampton,2014/2015,38,60,54,33,21,0.620689655,506,384,122,0.568539326,170,114,56,0.598591549,13.31578947,10.10526316,4.473684211,3,1.421052632,0.868421053
Stoke City,2014/2015,38,54,48,45,3,0.516129032,501,454,47,0.52460733,136,143,-7,0.487455197,13.18421053,11.94736842,3.578947368,3.763157895,1.263157895,1.184210526
Sunderland,2014/2015,38,38,31,53,-22,0.369047619,404,624,-220,0.392996109,129,197,-68,0.395705521,10.63157895,16.42105263,3.394736842,5.184210526,0.815789474,1.394736842
Swansea City,2014/2015,38,56,46,49,-3,0.484210526,422,552,-130,0.433264887,147,192,-45,0.433628319,11.10526316,14.52631579,3.868421053,5.052631579,1.210526316,1.289473684
Tottenham Hotspur,2014/2015,38,64,58,53,5,0.522522523,524,489,35,0.51727542,172,172,0,0.5,13.78947368,12.86842105,4.526315789,4.526315789,1.526315789,1.394736842
West Bromwich Albion,2014/2015,38,44,38,51,-13,0.426966292,411,544,-133,0.430366492,130,186,-56,0.411392405,10.81578947,14.31578947,3.421052632,4.894736842,1,1.342105263
West Ham United,2014/2015,38,47,44,47,-3,0.483516484,485,589,-104,0.451582868,152,179,-27,0.459214502,12.76315789,15.5,4,4.710526316,1.157894737,1.236842105
Arsenal,2015/2016,38,71,65,36,29,0.643564356,572,452,120,0.55859375,210,152,58,0.580110497,15.05263158,11.89473684,5.526315789,4,1.710526316,0.947368421
Aston Villa,2015/2016,38,17,27,76,-49,0.262135922,368,500,-132,0.423963134,111,191,-80,0.367549669,9.684210526,13.15789474,2.921052632,5.026315789,0.710526316,2
Bournemouth,2015/2016,38,42,45,67,-22,0.401785714,463,436,27,0.515016685,144,154,-10,0.483221477,12.18421053,11.47368421,3.789473684,4.052631579,1.184210526,1.763157895
Chelsea,2015/2016,38,50,59,53,6,0.526785714,526,482,44,0.521825397,173,179,-6,0.491477273,13.84210526,12.68421053,4.552631579,4.710526316,1.552631579,1.394736842
Crystal Palace,2015/2016,38,42,39,51,-12,0.433333333,466,569,-103,0.450241546,152,172,-20,0.469135802,12.26315789,14.97368421,4,4.526315789,1.026315789,1.342105263
Everton,2015/2016,38,47,59,55,4,0.51754386,492,551,-59,0.471716203,175,185,-10,0.486111111,12.94736842,14.5,4.605263158,4.868421053,1.552631579,1.447368421
Leicester City,2015/2016,38,81,68,36,32,0.653846154,523,516,7,0.503368624,181,143,38,0.558641975,13.76315789,13.57894737,4.763157895,3.763157895,1.789473684,0.947368421
Liverpool,2015/2016,38,60,63,50,13,0.557522124,629,397,232,0.613060429,203,133,70,0.604166667,16.55263158,10.44736842,5.342105263,3.5,1.657894737,1.315789474
Manchester City,2015/2016,38,66,71,41,30,0.633928571,612,336,276,0.64556962,210,125,85,0.626865672,16.10526316,8.842105263,5.526315789,3.289473684,1.868421053,1.078947368
Manchester United,2015/2016,38,66,49,35,14,0.583333333,430,411,19,0.511296076,143,123,20,0.537593985,11.31578947,10.81578947,3.763157895,3.236842105,1.289473684,0.921052632
Newcastle United,2015/2016,38,37,44,65,-21,0.403669725,398,554,-156,0.418067227,152,178,-26,0.460606061,10.47368421,14.57894737,4,4.684210526,1.157894737,1.710526316
Norwich City,2015/2016,38,34,39,67,-28,0.367924528,416,490,-74,0.459161148,126,172,-46,0.422818792,10.94736842,12.89473684,3.315789474,4.526315789,1.026315789,1.763157895
Southampton,2015/2016,38,63,59,41,18,0.59,519,460,59,0.530132789,169,140,29,0.546925566,13.65789474,12.10526316,4.447368421,3.684210526,1.552631579,1.078947368
Stoke City,2015/2016,38,51,41,55,-14,0.427083333,418,533,-115,0.439537329,130,177,-47,0.423452769,11,14.02631579,3.421052632,4.657894737,1.078947368,1.447368421
Sunderland,2015/2016,38,39,48,62,-14,0.436363636,439,569,-130,0.435515873,143,218,-75,0.396121884,11.55263158,14.97368421,3.763157895,5.736842105,1.263157895,1.631578947
Swansea City,2015/2016,38,47,42,52,-10,0.446808511,442,523,-81,0.458031088,136,169,-33,0.445901639,11.63157895,13.76315789,3.578947368,4.447368421,1.105263158,1.368421053
Tottenham Hotspur,2015/2016,38,70,69,35,34,0.663461538,661,421,240,0.61090573,250,121,129,0.673854447,17.39473684,11.07894737,6.578947368,3.184210526,1.815789474,0.921052632
Watford,2015/2016,38,45,40,50,-10,0.444444444,445,499,-54,0.471398305,136,174,-38,0.438709677,11.71052632,13.13157895,3.578947368,4.578947368,1.052631579,1.315789474
West Bromwich Albion,2015/2016,38,43,34,48,-14,0.414634146,384,547,-163,0.412459721,106,160,-54,0.398496241,10.10526316,14.39473684,2.789473684,4.210526316,0.894736842,1.263157895
West Ham United,2015/2016,38,62,65,51,14,0.560344828,556,513,43,0.520112254,184,168,16,0.522727273,14.63157895,13.5,4.842105263,4.421052632,1.710526316,1.342105263
Arsenal,2016/2017,38,75,77,44,33,0.636363636,565,431,134,0.567269076,200,167,33,0.544959128,14.86842105,11.34210526,5.263157895,4.394736842,2.026315789,1.157894737
Bournemouth,2016/2017,38,46,55,67,-12,0.450819672,446,551,-105,0.447342026,160,189,-29,0.458452722,11.73684211,14.5,4.210526316,4.973684211,1.447368421,1.763157895
Burnley,2016/2017,38,40,39,55,-16,0.414893617,390,667,-277,0.36896878,120,211,-91,0.362537764,10.26315789,17.55263158,3.157894737,5.552631579,1.026315789,1.447368421
Chelsea,2016/2017,38,93,85,33,52,0.720338983,580,322,258,0.643015521,204,105,99,0.660194175,15.26315789,8.473684211,5.368421053,2.763157895,2.236842105,0.868421053
Crystal Palace,2016/2017,38,41,50,63,-13,0.442477876,438,517,-79,0.458638743,138,177,-39,0.438095238,11.52631579,13.60526316,3.631578947,4.657894737,1.315789474,1.657894737
Everton,2016/2017,38,61,62,44,18,0.58490566,498,445,53,0.528101803,192,148,44,0.564705882,13.10526316,11.71052632,5.052631579,3.894736842,1.631578947,1.157894737
Hull City,2016/2017,38,34,37,80,-43,0.316239316,396,618,-222,0.390532544,127,215,-88,0.371345029,10.42105263,16.26315789,3.342105263,5.657894737,0.973684211,2.105263158
Leicester City,2016/2017,38,44,48,63,-15,0.432432432,432,554,-122,0.438133874,145,191,-46,0.431547619,11.36842105,14.57894737,3.815789474,5.026315789,1.263157895,1.657894737
Liverpool,2016/2017,38,76,78,42,36,0.65,638,307,331,0.675132275,236,114,122,0.674285714,16.78947368,8.078947368,6.210526316,3,2.052631579,1.105263158
Manchester City,2016/2017,38,78,80,39,41,0.672268908,633,299,334,0.679184549,217,106,111,0.671826625,16.65789474,7.868421053,5.710526316,2.789473684,2.105263158,1.026315789
Manchester United,2016/2017,38,69,54,29,25,0.65060241,589,358,231,0.621964097,210,114,96,0.648148148,15.5,9.421052632,5.526315789,3,1.421052632,0.763157895
Middlesbrough,2016/2017,38,28,27,53,-26,0.3375,349,548,-199,0.389074693,100,172,-72,0.367647059,9.184210526,14.42105263,2.631578947,4.526315789,0.710526316,1.394736842
Southampton,2016/2017,38,46,41,48,-7,0.460674157,548,436,112,0.556910569,179,128,51,0.583061889,14.42105263,11.47368421,4.710526316,3.368421053,1.078947368,1.263157895
Stoke City,2016/2017,38,44,41,56,-15,0.422680412,426,538,-112,0.441908714,137,181,-44,0.43081761,11.21052632,14.15789474,3.605263158,4.763157895,1.078947368,1.473684211
Sunderland,2016/2017,38,24,29,69,-40,0.295918367,387,675,-288,0.36440678,121,248,-127,0.327913279,10.18421053,17.76315789,3.184210526,6.526315789,0.763157895,1.815789474
Swansea City,2016/2017,38,41,45,70,-25,0.391304348,390,518,-128,0.429515419,146,185,-39,0.441087613,10.26315789,13.63157895,3.842105263,4.868421053,1.184210526,1.842105263
Tottenham Hotspur,2016/2017,38,86,86,26,60,0.767857143,669,348,321,0.657817109,257,111,146,0.698369565,17.60526316,9.157894737,6.763157895,2.921052632,2.263157895,0.684210526
Watford,2016/2017,38,40,40,68,-28,0.37037037,419,538,-119,0.437826541,144,189,-45,0.432432432,11.02631579,14.15789474,3.789473684,4.973684211,1.052631579,1.789473684
West Bromwich Albion,2016/2017,38,45,43,51,-8,0.457446809,400,517,-117,0.436205016,123,162,-39,0.431578947,10.52631579,13.60526316,3.236842105,4.263157895,1.131578947,1.342105263
West Ham United,2016/2017,38,45,47,64,-17,0.423423423,496,502,-6,0.496993988,138,181,-43,0.432601881,13.05263158,13.21052632,3.631578947,4.763157895,1.236842105,1.684210526
Arsenal,2017/2018,38,63,74,51,23,0.592,591,422,169,0.583415597,233,148,85,0.611548556,15.55263158,11.10526316,6.131578947,3.894736842,1.947368421,1.342105263
Bournemouth,2017/2018,38,44,45,61,-16,0.424528302,466,548,-82,0.459566075,157,176,-19,0.471471471,12.26315789,14.42105263,4.131578947,4.631578947,1.184210526,1.605263158
Brighton,2017/2018,38,40,34,54,-20,0.386363636,383,555,-172,0.408315565,118,181,-63,0.394648829,10.07894737,14.60526316,3.105263158,4.763157895,0.894736842,1.421052632
Burnley,2017/2018,38,54,36,39,-3,0.48,379,562,-183,0.402763018,127,164,-37,0.436426117,9.973684211,14.78947368,3.342105263,4.315789474,0.947368421,1.026315789
Chelsea,2017/2018,38,70,62,38,24,0.62,606,377,229,0.616480163,220,120,100,0.647058824,15.94736842,9.921052632,5.789473684,3.157894737,1.631578947,1
Crystal Palace,2017/2018,38,44,45,55,-10,0.45,475,462,13,0.506937033,151,176,-25,0.4617737,12.5,12.15789474,3.973684211,4.631578947,1.184210526,1.447368421
Everton,2017/2018,38,49,44,58,-14,0.431372549,360,542,-182,0.399113082,122,183,-61,0.4,9.473684211,14.26315789,3.210526316,4.815789474,1.157894737,1.526315789
Huddersfield,2017/2018,38,37,28,58,-30,0.325581395,360,441,-81,0.449438202,111,165,-54,0.402173913,9.473684211,11.60526316,2.921052632,4.342105263,0.736842105,1.526315789
Leicester City,2017/2018,38,47,56,60,-4,0.482758621,422,490,-68,0.462719298,148,168,-20,0.46835443,11.10526316,12.89473684,3.894736842,4.421052632,1.473684211,1.578947368
Liverpool,2017/2018,38,75,84,38,46,0.68852459,640,282,358,0.694143167,233,103,130,0.693452381,16.84210526,7.421052632,6.131578947,2.710526316,2.210526316,1
Manchester City,2017/2018,38,100,106,27,79,0.796992481,664,238,426,0.736141907,261,87,174,0.75,17.47368421,6.263157895,6.868421053,2.289473684,2.789473684,0.710526316
Manchester United,2017/2018,38,81,68,28,40,0.708333333,513,436,77,0.54056902,181,146,35,0.55351682,13.5,11.47368421,4.763157895,3.842105263,1.789473684,0.736842105
Newcastle United,2017/2018,38,44,39,47,-8,0.453488372,449,479,-30,0.483836207,150,157,-7,0.488599349,11.81578947,12.60526316,3.947368421,4.131578947,1.026315789,1.236842105
Southampton,2017/2018,38,36,37,56,-19,0.397849462,451,493,-42,0.477754237,145,170,-25,0.46031746,11.86842105,12.97368421,3.815789474,4.473684211,0.973684211,1.473684211
Stoke City,2017/2018,38,33,35,68,-33,0.339805825,382,578,-196,0.397916667,131,220,-89,0.373219373,10.05263158,15.21052632,3.447368421,5.789473684,0.921052632,1.789473684
Swansea City,2017/2018,38,33,28,56,-28,0.333333333,336,538,-202,0.384439359,104,191,-87,0.352542373,8.842105263,14.15789474,2.736842105,5.026315789,0.736842105,1.473684211
Tottenham Hotspur,2017/2018,38,77,74,36,38,0.672727273,622,355,267,0.636642784,217,126,91,0.632653061,16.36842105,9.342105263,5.710526316,3.315789474,1.947368421,0.947368421
Watford,2017/2018,38,41,44,64,-20,0.407407407,440,413,27,0.515826495,132,160,-28,0.452054795,11.57894737,10.86842105,3.473684211,4.210526316,1.157894737,1.684210526
West Bromwich Albion,2017/2018,38,31,31,56,-25,0.356321839,375,515,-140,0.421348315,114,157,-43,0.420664207,9.868421053,13.55263158,3,4.131578947,0.815789474,1.473684211
West Ham United,2017/2018,38,42,48,68,-20,0.413793103,373,561,-188,0.399357602,133,190,-57,0.411764706,9.815789474,14.76315789,3.5,5,1.263157895,1.789473684
Arsenal,2018/2019,38,70,73,51,22,0.588709677,466,494,-28,0.485416667,170,183,-13,0.481586402,12.26315789,13,4.473684211,4.815789474,1.921052632,1.342105263
Bournemouth,2018/2019,38,45,56,70,-14,0.444444444,447,521,-74,0.46177686,163,175,-12,0.482248521,11.76315789,13.71052632,4.289473684,4.605263158,1.473684211,1.842105263
Brighton,2018/2019,38,36,35,60,-25,0.368421053,365,582,-217,0.385427666,108,175,-67,0.381625442,9.605263158,15.31578947,2.842105263,4.605263158,0.921052632,1.578947368
Burnley,2018/2019,38,40,45,68,-23,0.398230088,371,640,-269,0.366963403,115,204,-89,0.360501567,9.763157895,16.84210526,3.026315789,5.368421053,1.184210526,1.789473684
Cardiff City,2018/2019,38,34,34,69,-35,0.330097087,417,571,-154,0.422064777,126,212,-86,0.372781065,10.97368421,15.02631579,3.315789474,5.578947368,0.894736842,1.815789474
Chelsea,2018/2019,38,72,63,39,24,0.617647059,596,359,237,0.62408377,192,127,65,0.601880878,15.68421053,9.447368421,5.052631579,3.342105263,1.657894737,1.026315789
Crystal Palace,2018/2019,38,49,51,53,-2,0.490384615,491,525,-34,0.483267717,146,164,-18,0.470967742,12.92105263,13.81578947,3.842105263,4.315789474,1.342105263,1.394736842
Everton,2018/2019,38,54,54,46,8,0.54,495,402,93,0.551839465,169,137,32,0.552287582,13.02631579,10.57894737,4.447368421,3.605263158,1.421052632,1.210526316
Fulham,2018/2019,38,26,34,81,-47,0.295652174,453,583,-130,0.437258687,149,225,-76,0.398395722,11.92105263,15.34210526,3.921052632,5.921052632,0.894736842,2.131578947
Huddersfield,2018/2019,38,16,22,76,-54,0.224489796,400,520,-120,0.434782609,118,191,-73,0.381877023,10.52631579,13.68421053,3.105263158,5.026315789,0.578947368,2
Leicester City,2018/2019,38,52,51,48,3,0.515151515,515,426,89,0.547290117,184,139,45,0.569659443,13.55263158,11.21052632,4.842105263,3.657894737,1.342105263,1.263157895
Liverpool,2018/2019,38,97,89,22,67,0.801801802,574,307,267,0.65153235,226,97,129,0.699690402,15.10526316,8.078947368,5.947368421,2.552631579,2.342105263,0.578947368
Manchester City,2018/2019,38,98,95,23,72,0.805084746,683,236,447,0.743199129,260,83,177,0.758017493,17.97368421,6.210526316,6.842105263,2.184210526,2.5,0.605263158
Manchester United,2018/2019,38,66,65,54,11,0.546218487,526,493,33,0.516192345,225,173,52,0.565326633,13.84210526,12.97368421,5.921052632,4.552631579,1.710526316,1.421052632
Newcastle United,2018/2019,38,45,42,48,-6,0.466666667,444,489,-45,0.475884244,142,148,-6,0.489655172,11.68421053,12.86842105,3.736842105,3.894736842,1.105263158,1.263157895
Southampton,2018/2019,38,39,45,65,-20,0.409090909,480,523,-43,0.478564307,162,179,-17,0.475073314,12.63157895,13.76315789,4.263157895,4.710526316,1.184210526,1.710526316
Tottenham Hotspur,2018/2019,38,71,67,39,28,0.632075472,536,463,73,0.536536537,189,159,30,0.543103448,14.10526316,12.18421053,4.973684211,4.184210526,1.763157895,1.026315789
Watford,2018/2019,38,50,52,59,-7,0.468468468,434,490,-56,0.46969697,151,184,-33,0.450746269,11.42105263,12.89473684,3.973684211,4.842105263,1.368421053,1.552631579
West Ham United,2018/2019,38,52,52,55,-3,0.485981308,441,528,-87,0.455108359,157,200,-43,0.43977591,11.60526316,13.89473684,4.131578947,5.263157895,1.368421053,1.447368421
Wolves,2018/2019,38,57,47,46,1,0.505376344,474,456,18,0.509677419,151,148,3,0.505016722,12.47368421,12,3.973684211,3.894736842,1.236842105,1.210526316
Arsenal,2019/2020,38,56,56,48,8,0.538461538,406,554,-148,0.422916667,151,194,-43,0.437681159,10.68421053,14.57894737,3.973684211,5.105263158,1.473684211,1.263157895
Aston Villa,2019/2020,38,35,41,67,-26,0.37962963,457,607,-150,0.429511278,150,185,-35,0.447761194,12.02631579,15.97368421,3.947368421,4.868421053,1.078947368,1.763157895
Bournemouth,2019/2020,38,34,40,65,-25,0.380952381,389,558,-169,0.410770855,122,195,-73,0.384858044,10.23684211,14.68421053,3.210526316,5.131578947,1.052631579,1.710526316
Brighton,2019/2020,38,41,39,54,-15,0.419354839,462,498,-36,0.48125,143,170,-27,0.45686901,12.15789474,13.10526316,3.763157895,4.473684211,1.026315789,1.421052632
Burnley,2019/2020,38,54,43,50,-7,0.462365591,388,539,-151,0.418554477,134,170,-36,0.440789474,10.21052632,14.18421053,3.526315789,4.473684211,1.131578947,1.315789474
Chelsea,2019/2020,38,66,69,54,15,0.56097561,625,322,303,0.659978881,223,117,106,0.655882353,16.44736842,8.473684211,5.868421053,3.078947368,1.815789474,1.421052632
Crystal Palace,2019/2020,38,43,31,50,-19,0.382716049,376,514,-138,0.42247191,120,175,-55,0.406779661,9.894736842,13.52631579,3.157894737,4.605263158,0.815789474,1.315789474
Everton,2019/2020,38,49,44,56,-12,0.44,469,427,42,0.5234375,162,148,14,0.522580645,12.34210526,11.23684211,4.263157895,3.894736842,1.157894737,1.473684211
Leicester City,2019/2020,38,62,67,41,26,0.62037037,540,380,160,0.586956522,191,137,54,0.582317073,14.21052632,10,5.026315789,3.605263158,1.763157895,1.078947368
Liverpool,2019/2020,38,99,85,33,52,0.720338983,591,343,248,0.632762313,231,109,122,0.679411765,15.55263158,9.026315789,6.078947368,2.868421053,2.236842105,0.868421053
Manchester City,2019/2020,38,81,102,35,67,0.744525547,745,279,466,0.727539063,266,115,151,0.69816273,19.60526316,7.342105263,7,3.026315789,2.684210526,0.921052632
Manchester United,2019/2020,38,66,66,36,30,0.647058824,544,387,157,0.584317938,216,128,88,0.627906977,14.31578947,10.18421053,5.684210526,3.368421053,1.736842105,0.947368421
Newcastle United,2019/2020,38,44,38,58,-20,0.395833333,399,567,-168,0.413043478,133,200,-67,0.399399399,10.5,14.92105263,3.5,5.263157895,1,1.526315789
Norwich City,2019/2020,38,21,26,75,-49,0.257425743,409,605,-196,0.403353057,131,214,-83,0.379710145,10.76315789,15.92105263,3.447368421,5.631578947,0.684210526,1.973684211
Sheffield United,2019/2020,38,54,39,39,0,0.5,353,430,-77,0.45083014,114,140,-26,0.448818898,9.289473684,11.31578947,3,3.684210526,1.026315789,1.026315789
Southampton,2019/2020,38,52,51,60,-9,0.459459459,499,452,47,0.524710831,181,168,13,0.518624642,13.13157895,11.89473684,4.763157895,4.421052632,1.342105263,1.578947368
Tottenham Hotspur,2019/2020,38,59,61,47,14,0.564814815,444,536,-92,0.453061224,160,183,-23,0.466472303,11.68421053,14.10526316,4.210526316,4.815789474,1.605263158,1.236842105
Watford,2019/2020,38,34,36,64,-28,0.36,424,500,-76,0.458874459,122,183,-61,0.4,11.15789474,13.15789474,3.210526316,4.815789474,0.947368421,1.684210526
West Ham United,2019/2020,38,39,49,62,-13,0.441441441,417,501,-84,0.454248366,163,189,-26,0.463068182,10.97368421,13.18421053,4.289473684,4.973684211,1.289473684,1.631578947
Wolves,2019/2020,38,59,51,40,11,0.56043956,461,396,65,0.537922987,148,129,19,0.534296029,12.13157895,10.42105263,3.894736842,3.394736842,1.342105263,1.052631579
Arsenal,2020/2021,38,61,55,39,16,0.585106383,459,415,44,0.525171625,152,132,20,0.535211268,12.07894737,10.92105263,4,3.473684211,1.447368421,1.026315789
Aston Villa,2020/2021,38,55,55,46,9,0.544554455,520,538,-18,0.491493384,186,189,-3,0.496,13.68421053,14.15789474,4.894736842,4.973684211,1.447368421,1.210526316
Brighton,2020/2021,38,41,40,46,-6,0.465116279,487,358,129,0.576331361,143,127,16,0.52962963,12.81578947,9.421052632,3.763157895,3.342105263,1.052631579,1.210526316
Burnley,2020/2021,38,39,33,55,-22,0.375,384,570,-186,0.402515723,130,187,-57,0.410094637,10.10526316,15,3.421052632,4.921052632,0.868421053,1.447368421
Chelsea,2020/2021,38,67,58,36,22,0.617021277,556,336,220,0.623318386,210,109,101,0.65830721,14.63157895,8.842105263,5.526315789,2.868421053,1.526315789,0.947368421
Crystal Palace,2020/2021,38,44,41,66,-25,0.38317757,349,539,-190,0.393018018,132,176,-44,0.428571429,9.184210526,14.18421053,3.473684211,4.631578947,1.078947368,1.736842105
Everton,2020/2021,38,59,47,48,-1,0.494736842,400,505,-105,0.44198895,148,162,-14,0.477419355,10.52631579,13.28947368,3.894736842,4.263157895,1.236842105,1.263157895
Fulham,2020/2021,38,28,27,53,-26,0.3375,442,428,14,0.508045977,136,172,-36,0.441558442,11.63157895,11.26315789,3.578947368,4.526315789,0.710526316,1.394736842
Leeds United,2020/2021,38,59,62,54,8,0.534482759,522,558,-36,0.483333333,199,201,-2,0.4975,13.73684211,14.68421053,5.236842105,5.289473684,1.631578947,1.421052632
Leicester City,2020/2021,38,66,68,50,18,0.576271186,485,370,115,0.567251462,185,139,46,0.570987654,12.76315789,9.736842105,4.868421053,3.657894737,1.789473684,1.315789474
Liverpool,2020/2021,38,69,68,42,26,0.618181818,608,332,276,0.646808511,214,144,70,0.597765363,16,8.736842105,5.631578947,3.789473684,1.789473684,1.105263158
Manchester City,2020/2021,38,86,83,32,51,0.72173913,599,283,316,0.679138322,218,100,118,0.685534591,15.76315789,7.447368421,5.736842105,2.631578947,2.184210526,0.842105263
Manchester United,2020/2021,38,74,73,44,29,0.623931624,526,428,98,0.551362683,213,141,72,0.601694915,13.84210526,11.26315789,5.605263158,3.710526316,1.921052632,1.157894737
Newcastle United,2020/2021,38,45,46,62,-16,0.425925926,397,572,-175,0.409700722,142,194,-52,0.422619048,10.44736842,15.05263158,3.736842105,5.105263158,1.210526316,1.631578947
Sheffield United,2020/2021,38,23,20,63,-43,0.240963855,323,543,-220,0.372979215,99,215,-116,0.315286624,8.5,14.28947368,2.605263158,5.657894737,0.526315789,1.657894737
Southampton,2020/2021,38,43,47,68,-21,0.408695652,424,428,-4,0.497652582,168,180,-12,0.482758621,11.15789474,11.26315789,4.421052632,4.736842105,1.236842105,1.789473684
Tottenham Hotspur,2020/2021,38,62,68,45,23,0.601769912,443,486,-43,0.476856835,176,158,18,0.526946108,11.65789474,12.78947368,4.631578947,4.157894737,1.789473684,1.184210526
West Bromwich Albion,2020/2021,38,26,35,76,-41,0.315315315,339,599,-260,0.361407249,112,247,-135,0.311977716,8.921052632,15.76315789,2.947368421,6.5,0.921052632,2
West Ham United,2020/2021,38,65,62,47,15,0.568807339,468,464,4,0.502145923,165,152,13,0.520504732,12.31578947,12.21052632,4.342105263,4,1.631578947,1.236842105
Wolves,2020/2021,38,45,36,52,-16,0.409090909,463,442,21,0.51160221,154,157,-3,0.495176849,12.18421053,11.63157895,4.052631579,4.131578947,0.947368421,1.368421053